0 0 0 0 0 0 0 0 0 0
0 8 8 8 7 7 8 8 8 0
0 7 7 6 7 7 6 7 7 0
0 6 6 4 4 4 4 6 6 0
0 3 4 3 3 3 3 4 3 0
0 3 3 3 3 3 3 3 3 0
0 2 2 2 2 2 2 2 2 0
0 1 1 1 1 1 1 1 1 0
0 0 0 0 0 0 0 0 0 0