7 8 8 8 7 7 8 8 8 7
6 7 7 6 7 7 6 7 7 6
4 6 6 4 4 4 4 6 6 4
4 3 4 3 3 3 3 4 3 4
5 3 3 3 3 3 3 3 3 5
2 2 2 2 2 2 2 2 2 2
1 1 1 1 1 1 1 1 1 1
0 0 0 0 0 0 0 0 0 0