5 4 5 4 5 5 4 5 4 5
4 4 4 6 4 4 6 4 4 4
6 3 3 3 3 3 3 3 3 6
2 2 2 2 2 2 2 2 2 2
1 1 1 1 1 1 1 1 1 1
0 0 0 7 0 0 7 0 0 0